15
23
#######################
#                     #
#                     #
#                     #
#                     #
#                     #
S                     E
#                     #
#                     #
#                     #
#                     #
#                     #
#                     #
#                     #
#######################
