15
23
#E#####################
# # #   #   #     #  ##
# #  # #  # ## ##  #  #
#    # #   #   #     ##
### ## ### ### ### ####
#   #   ##   #   #  # S
##  # #   # ## ## ### #
# #   # # #  # #  #   #
#   # # ##  ## # #  # #
# # # # ##  ## # # ####
# # # # # #         # #
# # #      #  # #   # #
# #    ##  #   #  #   #
#   #   #         #   #
#######################
